{

    "tileset" : "sol.png",
    "terrain" : [
         [99,100,99,100,99,100,99,100,99,100,99,100,99,100,99,100,99,100,99,100,99,100,99,100,99,100,99,100,99,100,99,100,99,100,99,100,99,100,99,100,99,100,99,100,99,100,99,100],
         [99,100,99,100,99,100,99,100,99,100,99,100,99,100,99,100,99,100,99,100,99,100,99,100,99,100,99,100,99,100,99,100,99,100,99,100,99,100,99,100,99,100,99,100,99,100,99,100],
         [99,100,99,100,99,100,99,100,99,100,99,100,99,100,99,100,99,100,99,100,99,100,99,100,99,100,99,100,99,100,99,100,99,100,99,100,99,100,99,100,99,100,99,100,99,100,99,100],
         [99,100,99,100,99,100,99,100,99,100,99,100,99,100,99,100,99,100,99,100,99,100,99,100,99,100,99,100,99,100,99,100,99,100,99,100,99,100,99,100,99,100,99,100,99,100,99,100],
         [99,100,99,100,99,100,99,100,99,100,99,100,99,100,99,100,99,100,99,100,99,100,99,100,99,100,99,100,99,100,99,100,99,100,99,100,99,100,99,100,99,100,99,100,99,100,99,100],
         [99,100,99,100,99,100,99,100,99,100,99,100,99,100,99,100,99,100,99,100,99,100,99,100,99,100,99,100,99,100,99,100,99,100,99,100,99,100,99,100,99,100,99,100,99,100,99,100],
         [99,100,99,100,99,100,99,100,99,100,99,100,99,100,99,100,99,100,99,100,99,100,99,100,99,100,99,100,99,100,99,100,99,100,99,100,99,100,99,100,99,100,99,100,99,100,99,100],
         [99,100,99,100,99,100,99,100,99,100,99,100,99,100,99,100,99,100,99,100,99,100,99,100,99,100,99,100,99,100,99,100,99,100,99,100,99,100,99,100,99,100,99,100,99,100,99,100],
         [99,100,99,100,99,100,99,100,99,100,99,100,99,100,99,100,99,100,99,100,99,100,99,100,99,100,99,100,99,100,99,100,99,100,99,100,99,100,99,100,99,100,99,100,99,100,99,100],
         [99,100,99,100,99,100,99,100,99,100,99,100,99,100,99,100,99,100,99,100,99,100,99,100,99,100,99,100,99,100,99,100,99,100,99,100,99,100,99,100,99,100,99,100,99,100,99,100],
         [99,100,99,100,99,100,99,100,99,100,99,100,99,100,99,100,99,100,99,100,99,100,99,100,99,100,99,100,99,100,99,100,99,100,99,100,99,100,99,100,99,100,99,100,99,100,99,100],
         [99,100,99,100,99,100,99,100,99,100,99,100,99,100,99,100,99,100,99,100,99,100,99,100,99,100,99,100,99,100,99,100,99,100,99,100,99,100,99,100,99,100,99,100,99,100,99,100],
         [99,100,99,100,99,100,99,100,99,100,99,100,99,100,99,100,99,100,99,100,99,100,99,100,99,100,99,100,99,100,99,100,99,100,99,100,99,100,99,100,99,100,99,100,99,100,99,100],
         [99,100,99,100,99,100,99,100,99,100,99,100,99,100,99,100,99,100,99,100,99,100,99,100,99,100,99,100,99,100,99,100,99,100,99,100,99,100,99,100,99,100,99,100,99,100,99,100],
         [99,100,99,100,99,100,99,100,99,100,99,100,99,100,99,100,99,100,99,100,99,100,99,100,99,100,99,100,99,100,99,100,99,100,99,100,99,100,99,100,99,100,99,100,99,100,99,100],
         [99,100,99,100,99,100,99,100,99,100,99,100,99,100,99,100,99,100,99,100,99,100,99,100,99,100,99,100,99,100,99,100,99,100,99,100,99,100,99,100,99,100,99,100,99,100,99,100],
         [99,100,99,100,99,100,99,100,99,100,99,100,99,100,99,100,99,100,99,100,99,100,99,100,99,100,99,100,99,100,99,100,99,100,99,100,99,100,99,100,99,100,99,100,99,100,99,100],
         [99,100,99,100,99,100,99,100,99,100,99,100,99,100,99,100,99,100,99,100,99,100,99,100,99,100,99,100,99,100,99,100,99,100,99,100,99,100,99,100,99,100,99,100,99,100,99,100],
         [99,100,99,100,99,100,99,100,99,100,99,100,99,100,99,100,99,100,99,100,99,100,99,100,99,100,99,100,99,100,99,100,99,100,99,100,99,100,99,100,99,100,99,100,99,100,99,100],
         [99,100,99,100,99,100,99,100,99,100,99,100,99,100,99,100,99,100,99,100,99,100,99,100,99,100,99,100,99,100,99,100,99,100,99,100,99,100,99,100,99,100,99,100,99,100,99,100],
         [99,100,99,100,99,100,99,100,99,100,99,100,99,100,99,100,99,100,99,100,99,100,99,100,99,100,99,100,99,100,99,100,99,100,99,100,99,100,99,100,99,100,99,100,99,100,99,100],
         [99,100,99,100,99,100,99,100,99,100,99,100,99,100,99,100,99,100,99,100,99,100,99,100,99,100,99,100,99,100,99,100,99,100,99,100,99,100,99,100,99,100,99,100,99,100,99,100],
         [99,100,99,100,99,100,99,100,99,100,99,100,99,100,99,100,99,100,99,100,99,100,50,50,50,100,99,100,99,100,99,100,99,100,99,100,99,100,99,100,99,100,99,100,99,100,99,100],
         [99,100,99,100,99,100,99,100,99,100,99,100,99,100,99,100,99,100,99,100,99,100,50,50,50,100,99,100,99,100,99,100,99,100,99,100,99,100,99,100,99,100,99,100,99,100,99,100]
    ]

}
