{

    "tileset" : "sol.png",
    "terrain" : [
         [99,100,195,195,193,194,195,195,193,194,247,248,247,248,193,194,193,194,195,195,193,194,100,99,100,195,195,193,194,247,248,193,194,195,195,195,193,194,195,195,195,195,193,194,195,195,100,99],
         [99,100,211,211,209,210,211,211,209,210,263,264,263,264,209,210,209,210,211,211,209,210,100,99,99,211,211,209,210,264,263,209,210,211,211,211,209,210,211,211,211,211,209,210,211,211,100,99],
         [99,100,99,100,99,100,99,100,99,100,99,100,99,100,99,100,99,100,99,100,99,100,99,100,99,100,99,100,99,100,99,100,99,100,99,100,99,100,99,100,99,100,99,100,99,100,99,100],
         [99,100,99,100,99,100,99,100,99,100,99,100,99,100,99,100,99,100,99,100,99,100,99,100,99,100,99,100,99,100,99,100,99,100,99,100,99,100,99,100,99,100,99,100,99,100,99,100],
         [99,100,99,100,99,100,99,100,99,100,99,100,99,100,99,100,99,100,99,100,99,100,99,100,99,100,99,100,99,100,99,100,99,100,99,100,99,100,99,100,99,100,99,100,99,100,99,100],
         [99,100,99,100,99,100,99,100,99,100,99,100,99,100,99,100,99,100,99,100,99,100,99,100,99,100,99,100,99,100,99,100,99,100,99,100,99,100,99,100,99,100,99,100,99,100,99,100],
         [99,100,99,100,99,100,99,100,99,100,99,100,99,100,99,100,99,100,99,100,99,100,99,100,99,100,99,100,99,100,99,100,99,100,99,100,99,100,99,100,99,100,99,100,99,100,99,100],
         [99,100,99,100,99,100,99,100,99,100,99,100,99,100,99,100,99,100,99,100,99,100,99,100,99,100,99,100,99,100,99,100,99,100,99,100,99,100,99,100,99,100,99,100,99,100,99,100],
         [99,100,99,100,99,100,99,100,99,100,99,100,99,100,99,100,99,100,99,100,99,100,99,100,99,100,99,100,99,100,99,100,99,100,99,100,99,100,99,100,99,100,99,100,99,100,99,100],
         [99,100,99,100,99,100,99,100,99,100,99,100,99,100,99,100,99,100,99,100,99,100,99,100,99,100,99,100,99,100,99,100,99,100,99,100,99,100,99,100,99,100,99,100,99,100,99,100],
         [99,100,99,100,99,100,99,100,99,100,99,100,99,100,99,100,99,100,99,100,99,100,99,100,99,100,99,100,99,100,99,100,99,100,99,100,99,100,99,100,99,100,99,100,99,100,99,100],
         [99,100,99,100,99,100,99,100,99,100,99,100,99,100,99,100,99,100,99,100,99,100,99,100,99,100,99,100,99,100,99,100,99,100,99,100,99,100,99,100,99,100,99,100,99,100,99,100],
         [99,100,99,100,99,100,99,100,99,100,99,100,99,100,99,100,99,100,99,100,99,100,99,100,99,100,99,100,99,100,99,100,99,100,99,100,99,100,99,100,99,100,99,100,99,100,99,100],
         [99,100,99,100,99,100,99,100,99,100,99,100,99,100,99,100,99,100,99,100,99,100,99,100,99,100,99,100,99,100,99,100,99,100,99,100,99,100,99,100,99,100,99,100,99,100,99,100],
         [99,100,99,100,99,100,99,100,99,100,99,100,99,100,99,100,99,100,99,100,99,100,99,100,99,100,99,100,99,100,99,100,99,100,99,100,99,100,99,100,99,100,99,100,99,100,99,100],
         [99,100,99,100,99,100,99,100,99,100,99,100,99,100,99,100,99,100,99,100,99,100,99,100,99,100,99,100,99,100,99,100,99,100,99,100,99,100,99,100,99,100,99,100,99,100,99,100],
         [99,100,99,100,99,100,99,100,99,100,99,100,99,100,99,100,99,100,99,100,99,100,99,100,99,100,99,100,99,100,99,100,99,100,99,100,99,100,99,100,99,100,99,100,99,100,99,100],
         [99,100,99,100,99,100,99,100,99,100,99,100,99,100,99,100,99,100,99,100,99,100,99,100,99,100,99,100,99,100,99,100,99,100,99,100,99,100,99,100,99,100,99,100,99,100,99,100],
         [99,100,99,100,99,100,99,100,99,100,99,100,99,100,99,100,99,100,99,100,99,100,99,100,99,100,99,100,99,100,99,100,99,100,99,100,99,100,99,100,99,100,99,100,99,100,99,100],
         [99,100,99,100,99,100,99,100,99,100,99,100,99,100,99,100,99,100,99,100,99,100,99,100,99,100,99,100,99,100,99,100,99,100,99,100,99,100,99,100,99,100,99,100,99,100,99,100],
         [99,100,99,100,99,100,99,100,99,100,99,100,99,100,99,100,99,100,99,100,99,100,99,100,99,100,99,100,99,100,99,100,99,100,99,100,99,100,99,100,99,100,99,100,99,100,99,100],
         [99,100,99,100,99,100,99,100,99,100,99,100,99,100,99,100,99,100,99,100,99,100,99,100,99,100,99,100,99,100,99,100,99,100,99,100,99,100,99,100,99,100,99,100,99,100,99,100],
         [99,100,99,100,99,100,99,100,99,100,99,100,99,100,99,100,99,100,99,100,99,100,50,50,50,100,99,100,99,100,99,100,99,100,99,100,99,100,99,100,99,100,99,100,99,100,99,100],
         [99,100,99,100,99,100,99,100,99,100,99,100,99,100,99,100,99,100,99,100,99,100,50,50,50,100,99,100,99,100,99,100,99,100,99,100,99,100,99,100,99,100,99,100,99,100,99,100]
    ]

}
