{

    "tileset" : "base_out_atlas.png",
    "terrain" : [
         [403,403,403,34,35,36,37,403,403,403,403,403,403,403,403,403,403,403,403,194,194,194,194,403,403,403,403,403,403,403,403,403,38,39,40,403,403,403,403,403,403,403,403,403,403,403,403,403],
         [403,403,109,110,111,112,113,403,403,403,403,403,403,403,403,403,403,497,403,194,194,194,194,403,403,403,403,403,403,403,403,403,114,115,116,403,403,403,403,403,403,403,403,403,403,403,403,403],
         [403,403,185,186,187,188,189,403,403,403,403,403,403,403,403,403,403,403,403,194,194,194,194,403,403,403,403,403,403,403,403,403,190,191,192,403,403,403,403,403,403,403,403,403,403,403,403,403],
         [403,403,261,262,263,264,265,403,403,403,403,403,403,403,403,403,403,403,403,194,194,194,194,403,403,403,403,403,403,403,403,403,266,267,268,403,403,403,403,403,403,403,403,403,403,403,403,403],
         [403,403,337,338,339,340,341,403,403,403,403,403,403,403,403,403,403,403,403,194,194,194,194,403,403,403,403,403,403,403,403,403,1145,1145,1145,403,403,403,403,403,403,403,403,403,403,403,403,403],
         [403,403,413,414,415,416,417,403,403,403,403,403,403,403,403,403,403,403,403,194,194,194,194,403,403,403,403,403,403,403,403,403,1145,1145,1145,403,403,403,403,403,403,403,403,403,403,403,403,403],
         [403,403,403,1186,1187,1188,403,403,403,403,403,403,403,403,403,403,403,403,403,194,194,194,194,403,403,403,403,403,403,403,403,403,1145,1145,1145,403,403,403,403,403,403,403,403,403,403,403,403,403],
         [403,403,403,1262,1263,1264,403,403,403,403,403,403,403,403,403,403,403,403,403,194,194,194,194,403,403,403,403,403,403,403,403,403,1145,1145,1145,403,403,403,403,403,403,403,403,403,403,403,403,403],
         [403,403,403,1262,1263,1264,403,403,403,403,403,403,403,403,403,403,403,403,403,194,194,194,194,403,403,403,403,403,403,403,403,403,1145,1145,1145,403,403,403,403,403,403,403,403,403,403,403,403,403],
         [194,194,194,194,194,194,194,194,194,194,194,194,194,194,194,194,194,194,194,194,194,194,194,194,194,194,194,194,194,194,194,194,194,194,194,194,194,194,194,194,194,194,194,194,194,194,194,194],
         [194,194,194,194,194,194,194,194,194,194,194,194,194,194,194,194,194,194,194,194,194,194,194,194,194,194,194,194,194,194,194,194,194,194,194,194,194,194,194,194,194,194,194,194,194,194,194,194],
         [403,403,403,403,403,403,403,403,403,403,403,403,403,403,403,403,403,403,403,194,194,194,194,403,403,403,403,403,403,403,403,403,403,403,403,403,403,403,403,403,403,403,403,403,403,403,403,403],
         [403,403,403,1173,1174,1175,1176,403,403,403,403,403,403,403,403,403,403,403,403,194,194,194,194,403,403,403,403,403,403,793,794,795,403,403,403,403,403,403,403,403,403,403,403,403,403,403,403,403],
         [403,403,403,1249,1250,1251,1252,403,403,403,403,403,403,403,403,403,403,403,403,194,194,194,194,403,403,403,403,403,403,945,946,947,403,403,403,403,403,403,403,403,403,403,403,403,403,403,403,403],
         [403,403,403,1325,1326,1327,1328,403,403,403,403,403,403,403,403,403,403,403,403,194,194,194,194,403,403,403,403,403,403,1021,1022,1023,403,403,403,403,403,403,403,403,403,403,403,403,403,403,403,403],
         [403,403,403,1401,1402,1403,1404,403,403,403,403,403,403,403,403,403,403,403,403,194,194,194,194,403,403,403,403,403,403,403,2113,2114,403,403,403,403,403,403,403,403,403,403,403,403,403,403,403,403],
         [403,403,403,107,107,108,403,403,403,403,403,403,403,403,403,403,403,403,403,194,194,194,194,403,403,403,403,403,403,403,2113,2114,403,403,403,403,403,403,403,403,403,403,403,403,403,403,403,403],
         [403,403,403,107,107,108,403,403,403,403,403,403,403,403,403,403,403,403,403,194,194,194,194,403,403,403,403,403,403,403,2113,2114,403,403,403,403,403,403,403,403,403,403,403,403,403,403,403,403],
         [403,403,403,107,107,108,403,403,403,403,403,403,403,403,403,403,403,403,403,194,194,194,194,403,403,403,403,403,403,403,2113,2114,403,403,403,403,403,403,403,403,403,403,403,403,403,403,403,403],
         [403,403,403,107,107,108,403,403,403,403,403,403,403,403,403,403,403,403,403,194,194,194,194,403,403,403,403,403,403,403,2113,2114,403,403,403,403,403,403,403,403,403,403,403,403,403,403,403,403],
         [194,194,194,194,194,194,194,194,194,194,194,194,194,194,194,194,194,194,194,194,194,194,194,194,194,194,194,194,194,194,194,194,194,194,194,194,194,194,194,194,194,194,194,194,194,194,194,194],
         [194,194,194,194,194,194,194,194,194,194,194,194,194,194,194,194,194,194,194,194,194,194,194,194,194,194,194,194,194,194,194,194,194,194,194,194,194,194,194,194,194,194,194,194,194,194,194,194],
         [403,403,403,403,403,403,403,403,403,403,403,403,403,403,403,403,403,403,403,194,194,194,194,403,403,403,403,403,403,403,403,403,403,403,403,403,403,403,403,403,403,403,403,403,403,403,403,403],
         [403,403,403,403,403,403,403,403,403,403,403,403,403,403,403,403,403,403,403,194,194,194,194,403,403,403,403,403,403,403,403,403,403,403,403,403,403,403,403,403,403,403,403,403,403,403,403,403]
    ]

}
